100000030000001
100000000000001
100011111110001
100000000000001
100000000000001
111110020011111
100000000000001
100000000500001
100011111110001
100000000000001
100000000000001
111111000111111
444444444444444